############
S #   #   ##
# # # # # ##
#   #   # ##
######### ##
# #       ##
# # ########
# #   #   ##
# # # ### ##
#   #      F
############